State,"Winter_2015
No_of_colonies","Spring_2015
No_of_colonies","Summer_2015
No_of_colonies","Fall_2015
No_of_colonies",2015_No_of_colonies,"Winter_2015
Lost","Spring_2015
Lost","Summer_2015
Lost","Fall_2015
Lost",2015_Lost,"Winter_2015
Per_lost","Spring_2015
Per_lost","Summer_2015
Per_lost","Fall_2015
Per_lost",2015_Per_lost,"Winter_2015
Added","Spring_2015
Added","Summer_2015
Added","Fall_2015
Added",2015_Added,"Winter_2015
Renovated","Spring_2015
Renovated","Summer_2015
Renovated","Fall_2015
Renovated",2015_Reno,"Winter_2015
Per_renovated","Spring_2015
Per_renovated","Summer_2015
Per_renovated","Fall_2015
Per_renovated",2015_Per_reno
Alabama,7000,7500,8500,8000,31000,1800,860,1400,610,4670,26,12,16,8,15.5,2800,1900,160,80,4940,250,680,260,60,1250,4,9,3,1,4.25
Arizona,35000,33000,40000,36000,144000,4600,5500,6000,12000,28100,13,17,15,31,19,3400,19500,4300,3000,30200,2100,7000,15500,16000,40600,6,21,39,41,26.75
Arkansas,13000,13500,23000,23000,72500,1500,1900,9000,2400,14800,11,14,30,9,16,1200,11500,500,1900,15100,90,5500,210,0,5800,1,41,1,0,10.75
California,1440000,1040000,730000,750000,3960000,255000,104000,76000,149000,584000,15,10,10,12,11.75,250000,170000,40000,39000,499000,124000,285000,93000,75000,577000,7,27,12,6,13
Colorado,3500,12000,29000,24000,68500,1500,1900,4500,2500,10400,12,8,15,10,11.25,200,6000,1400,3400,11000,140,3500,1400,0,5040,1,14,5,0,5
Connecticut,3900,3000,3700,3200,13800,870,80,50,210,1210,22,3,1,7,8.25,290,1100,190,40,1620,0,150,440,70,660,0,5,12,2,4.75
Florida,305000,210000,164000,220000,899000,42000,35000,36000,37000,150000,13,16,16,14,14.75,54000,44000,37000,30000,165000,25000,24000,29000,28000,106000,8,11,13,11,10.75
Georgia,104000,114000,108000,110000,436000,14500,23000,13000,18000,68500,14,19,12,15,15,47000,25000,19500,4400,95900,9500,19000,15500,1900,45900,9,15,14,2,10
Hawaii,10500,13500,14500,13000,51500,380,120,2700,690,3890,4,1,19,5,7.25,3400,1100,1200,2700,8400,760,1200,5500,760,8220,7,9,38,6,15
Idaho,81000,62000,80000,121000,344000,3700,6500,14000,22000,46200,4,9,11,15,9.75,2600,16500,5500,5500,30100,8000,10500,11500,5500,35500,9,15,9,4,9.25
Illinois,6000,9500,14000,14000,43500,4200,1300,1400,690,7590,40,14,10,5,17.25,2300,6000,1300,0,9600,390,1500,1100,30,3020,4,16,8,0,7
Indiana,9000,8000,15000,11500,43500,2100,1300,1600,1100,6100,22,10,11,10,13.25,490,4900,1400,140,6930,120,4300,420,0,4840,1,34,3,0,9.5
Iowa,12500,12500,29000,35000,89000,3100,1400,3000,4300,11800,18,6,8,12,11,1700,6500,640,40,8880,270,3100,680,30,4080,2,13,2,0,4.25
Kansas,4600,6000,9000,8500,28100,1600,670,1000,3400,6670,23,10,11,40,21,450,2800,100,50,3400,70,420,160,20,670,1,6,2,0,2.25
Kentucky,7500,7500,10000,8500,33500,4100,980,1300,1100,7480,39,12,13,13,19.25,250,3600,170,20,4040,0,1500,550,10,2060,0,18,6,0,6
Louisiana,51000,44000,50000,55000,200000,8000,1800,2000,4900,16700,16,4,4,7,7.75,3100,6500,2300,1100,13000,6500,8000,1800,2400,18700,13,18,3,3,9.25
Maine,3100,4600,6000,4700,18400,380,3200,450,60,4090,6,11,8,1,6.5,20,3500,410,530,4460,0,700,140,20,860,0,2,2,0,1
Maryland,7500,8000,7000,7500,30000,4100,370,680,730,5880,41,3,9,8,15.25,1600,2600,730,0,4930,870,710,70,0,1650,9,7,1,0,4.25
Massachusetts,2900,4100,7500,4500,19000,1000,320,560,260,2140,22,2,8,6,9.5,260,940,290,30,1520,120,510,400,30,1060,3,4,5,1,3.25
Michigan,16500,58000,89000,67000,230500,11500,9500,7000,9000,37000,19,11,8,12,12.5,7500,13500,3300,210,24510,2400,5500,3800,1600,13300,4,6,4,2,4
Minnesota,28000,71000,133000,104000,336000,3700,12500,32000,10000,58200,5,10,24,10,12.25,690,20000,640,600,21930,530,21000,2300,40,23870,1,17,2,0,5
Mississippi,34000,89000,23000,31000,177000,8500,11000,3500,1500,24500,11,12,10,4,9.25,22000,5500,260,500,28260,7500,10000,110,230,17840,10,11,0,1,5.5
Missouri,12000,11500,14000,13500,51000,2000,500,1200,690,4390,15,4,9,5,8.25,220,1900,700,30,2850,910,1800,630,40,3380,7,14,5,0,6.5
Montana,8500,36000,140000,116000,300500,2200,4200,10500,10000,26900,6,2,7,8,5.75,1400,14000,3200,1000,19600,1100,33000,10000,80,44180,3,16,6,0,6.25
Nebraska,10000,29000,67000,72000,178000,2600,4100,6000,7000,19700,8,6,8,10,8,120,15500,500,10,16130,310,4600,6000,5500,16410,1,7,8,8,6
New Jersey,6000,8500,18500,8000,41000,1100,1800,210,270,3380,12,10,1,3,6.5,570,2100,190,20,2880,1600,2900,500,10,5010,18,15,3,0,9
New Mexico,7000,6500,6500,6000,26000,690,1000,1600,290,3580,10,12,25,5,13,190,1500,1300,290,3280,600,330,650,30,1610,9,4,10,1,6
New York,27000,24000,44000,45000,140000,6500,1100,6500,4000,18100,22,3,14,9,12,430,11000,4400,260,16090,950,1500,7000,10,9460,3,4,15,0,5.5
North Carolina,24000,19500,24000,22000,89500,7000,1800,2900,2200,13900,27,8,12,10,14.25,6000,5500,2500,510,14510,690,3300,1100,70,5160,3,14,5,0,5.5
North Dakota,57000,121000,460000,230000,868000,620,29000,93000,35000,157620,1,6,19,13,9.75,1800,39000,11000,2700,54500,530,61000,22000,9000,92530,0,14,4,3,5.25
Ohio,18000,17500,23000,19000,77500,10500,2100,1900,2400,16900,48,11,8,13,20,5000,10000,2300,200,17500,3300,6000,880,140,10320,15,32,4,1,13
Oklahoma,9500,25000,19500,5000,59000,6000,2200,230,650,9080,23,8,1,7,9.75,2600,5500,160,290,8550,260,2200,190,60,2710,1,8,1,1,2.75
Oregon,77000,82000,68000,100000,327000,6500,5500,8500,8500,29000,8,6,9,8,7.75,4300,14500,8000,200,27000,2400,9500,21000,1400,34300,3,10,21,1,8.75
Pennsylvania,14000,15500,25000,22000,76500,6500,1600,1800,2500,12400,31,8,7,11,14.25,360,8500,1800,1300,11960,0,2600,2400,6500,11500,0,14,10,28,13
South Carolina,17000,17500,12000,10000,56500,2700,950,2000,2200,7850,15,5,17,13,12.5,2700,1100,880,640,5320,1400,2000,580,1000,4980,8,11,5,6,7.5
South Dakota,50000,100000,295000,194000,639000,4600,21000,53000,9000,87600,5,7,18,4,8.5,8500,27000,2100,2400,40000,2800,23000,13000,0,38800,3,8,4,0,3.75
Tennessee,9500,7500,10000,8500,35500,2000,730,1200,1100,5030,21,10,12,11,13.5,1000,3600,500,70,5170,190,920,350,420,1880,2,12,4,4,5.5
Texas,191000,305000,76000,125000,697000,26000,33000,16500,25000,100500,10,11,12,10,10.75,82000,76000,5500,13000,176500,51000,94000,4800,2000,151800,20,30,4,1,13.75
Utah,6000,24000,31000,28000,89000,3300,3400,8000,1900,16600,14,13,22,7,14,2500,10000,1400,120,14020,290,3900,2200,100,6490,1,14,6,0,5.25
Vermont,5500,6000,6000,6500,24000,700,100,40,940,1780,13,2,1,15,7.75,1200,580,30,10,1820,20,50,20,10,100,0,1,0,0,0.25
Virginia,8000,7500,8000,7500,31000,2500,270,680,750,4200,28,4,9,10,12.75,800,2100,520,0,3420,460,430,220,350,1460,5,6,3,5,4.75
Washington,52000,105000,84000,87000,328000,14000,5000,11500,6500,37000,13,4,12,7,9,13500,15000,1800,330,30630,9000,13000,20000,170,42170,9,10,21,0,10
West Virginia,4700,4700,7000,7000,23400,1800,570,300,610,3280,30,12,4,9,13.75,570,2900,300,190,3960,60,590,270,140,1060,1,13,4,2,5
Wisconsin,16500,25000,60000,48000,149500,8000,4600,9000,6500,28100,28,7,15,14,16,3100,10000,1300,210,14610,2500,5500,4300,10,12310,9,9,7,0,6.25
Wyoming,5500,12000,29000,24000,70500,2000,3200,2500,1300,9000,17,13,7,5,10.5,2000,7500,270,30,9800,1400,5000,440,0,6840,12,20,1,0,8.25
United States,2824610,2849500,3132880,2874760,11681750,500020,352860,457100,412380,1722360,18,12,15,14,14.75,546980,661860,172990,117150,1498980,270530,692850,303070,158790,1425240,10,24,10,6,12.5
